*S*******
*     * *
* ***** *
* * *   *
* * *** *
*   *   *
*** * * *
*     * *
*******F*