0 0 X 1 0 1 1 0 
0 1 X 0 0 1 1 0 
1 1 X 1 1 0 1 0 
S 1 X X 0 0 1 0 
X 1 1 X 1 1 1 0 
X X X X 1 1 1 0 
